10
00AA000M00
000AA00000
0000AA0000
0000000000
00M0000M00
0000000000
0EEE00000J
0EEE000000
0EEE00M000
00M0000000