10
00AA000M00
000AA00000
R000A00000
R00000R000
R0M00R0M00
0000R00000
0EEE00000J
0EEE0R0R00
0EEE0RMR00
00000RRR00